4
../textures/wood.png
../textures/redbrick.png
../textures/redbrick-right.png
../textures/redbrick-left.png
17 17
1 1 1 1 1 1 1 1 1 2 1 1 1 1 1 1 1
1 0 0 0 1 0 0 0 0 0 0 0 0 0 2 0 1
1 0 1 1 1 0 1 1 1 0 1 1 1 0 1 0 1
1 0 1 0 0 0 1 0 1 0 1 0 1 0 1 0 1
1 0 1 0 1 1 1 0 1 0 1 0 1 0 1 0 1
1 0 0 0 0 0 0 0 1 0 1 0 0 0 1 0 1
1 2 1 1 1 1 1 0 1 0 1 3 1 0 1 0 1
1 0 0 0 0 0 2 0 2 0 0 0 1 0 0 0 3
1 0 1 1 1 0 1 1 1 1 1 0 1 3 1 0 1
1 0 1 0 0 0 0 0 0 0 0 0 3 0 1 0 1
1 0 1 1 1 3 1 1 1 1 1 1 1 0 1 0 1
1 0 1 0 0 0 0 0 1 0 0 0 1 0 0 0 1
1 0 1 0 1 1 1 0 1 0 1 1 1 0 1 1 1
1 0 1 0 0 0 1 0 1 0 0 0 0 0 0 0 1
1 0 1 1 1 0 1 0 1 1 1 1 1 1 1 0 1
1 0 0 0 0 0 1 0 0 0 0 0 0 0 1 0 1
1 1 1 1 1 1 1 1 1 1 1 1 1 1 1 1 1
