6
../Textures/Tiles074_2K_Color1024.png
../Textures/Plaster001_2K_Color1024.png
../Textures/PavingStones087_2K_Color1024.png
../Textures/arrow-right.png
../Textures/arrow-left.png
../Textures/goal.png
17 17
2 2 2 3 2 2 2 2 2 2 2 2 2 2 2 5 2
2 0 2 0 0 0 0 0 0 0 0 0 0 0 0 0 5
2 0 2 0 2 2 2 2 2 2 2 2 2 0 2 0 2
2 0 2 0 2 0 2 0 0 0 0 0 2 0 2 0 2
2 0 2 0 2 0 2 0 2 0 2 0 2 0 2 2 2
2 0 2 0 2 0 2 0 2 0 2 0 2 0 0 0 2
2 3 2 0 2 0 2 0 2 0 2 0 2 2 2 0 2
2 0 0 0 4 0 0 0 2 0 2 0 0 0 2 0 2
2 0 2 2 2 2 2 2 2 0 2 0 2 2 2 0 2
2 0 2 0 0 0 0 0 0 0 2 0 2 0 0 0 2
2 0 2 0 2 0 2 2 2 2 2 0 2 0 2 2 2
2 0 2 0 2 0 0 0 2 0 2 0 2 0 0 0 2
2 0 2 4 2 0 2 0 2 0 2 0 2 2 2 2 2
3 0 0 0 2 0 2 0 2 0 2 0 2 0 0 0 2
2 2 2 0 2 2 2 0 2 0 2 0 2 0 2 0 2
2 0 0 0 4 0 0 0 2 0 0 0 0 0 2 0 2
2 2 2 2 2 2 2 2 2 2 2 2 2 2 2 2 2
