6
../Textures/Tiles074_2K_Color1024.png
../Textures/Plaster001_2K_Color1024.png
../Textures/PavingStones087_2K_Color1024.png
../Textures/arrow-right.png
../Textures/arrow-left.png
../Textures/goal.png
21 21
2 2 2 2 2 2 2 2 2 3 2 2 2 2 2 2 2 2 2 5 2
2 0 0 0 0 0 0 0 0 0 0 0 0 0 0 0 0 0 0 0 5
2 3 2 2 2 2 2 0 2 0 2 2 2 2 2 2 2 2 2 2 2
2 0 0 0 0 0 3 0 2 0 2 0 0 0 0 0 0 0 0 0 2
2 0 2 4 2 0 2 2 2 0 2 0 2 2 2 2 2 2 2 0 2
3 0 0 0 2 0 0 0 0 0 4 0 2 0 0 0 0 0 2 0 2
2 0 2 0 2 4 2 2 2 2 2 0 2 0 2 0 2 0 2 0 2
2 0 2 0 2 0 0 0 2 0 0 0 2 0 2 0 2 0 2 0 2
2 0 2 0 2 0 2 0 2 0 2 2 2 0 2 0 2 2 2 0 2
2 0 2 0 2 0 2 0 0 0 2 0 0 0 2 0 2 0 0 0 2
2 3 2 0 2 0 2 2 2 2 2 0 2 2 2 0 2 0 2 2 2
2 0 0 0 4 0 2 0 2 0 2 0 0 0 2 0 2 0 2 0 2
2 0 2 0 2 0 2 0 2 0 2 2 2 0 2 0 2 0 2 0 2
2 0 2 0 2 0 0 0 2 0 0 0 2 0 2 0 0 0 2 0 2
2 0 2 0 2 2 2 2 2 0 2 0 2 0 2 2 2 2 2 0 2
2 0 2 0 0 0 0 0 2 0 2 0 2 0 0 0 2 0 0 0 2
2 0 2 2 2 2 2 2 2 0 2 0 2 2 2 0 2 2 2 0 2
3 0 0 0 2 0 0 0 2 0 2 0 0 0 2 0 0 0 2 0 2
2 0 2 0 2 0 2 0 2 0 2 2 2 0 2 2 2 0 2 0 2
2 0 2 0 0 0 2 0 0 0 0 0 2 0 0 0 0 0 0 0 2
2 2 2 2 2 2 2 2 2 2 2 2 2 2 2 2 2 2 2 2 2
3 3 Dir.WEST
1 3 Dir.NORTH
1 5 Dir.NORTH
1 7 Dir.NORTH
1 9 Dir.EAST
3 9 Dir.NORTH
3 11 Dir.NORTH
3 13 Dir.NORTH
3 15 Dir.WEST
1 15 Dir.NORTH
1 17 Dir.EAST
3 17 Dir.EAST
5 17 Dir.SOUTH
5 15 Dir.EAST
7 15 Dir.EAST
9 15 Dir.NORTH
9 17 Dir.NORTH
9 19 Dir.EAST
11 19 Dir.EAST
13 19 Dir.EAST
15 19 Dir.EAST
17 19 Dir.EAST
