6
../Textures/Tiles074_2K_Color1024.png
../Textures/Plaster001_2K_Color1024.png
../Textures/PavingStones087_2K_Color1024.png
../Textures/arrow-right-long.png
../Textures/arrow-left-long.png
../Textures/goal.png
17 17
2 2 2 2 2 2 2 2 2 2 2 2 2 2 2 5 2
2 0 0 0 0 0 2 0 0 0 0 0 2 0 0 0 5
2 0 2 2 2 0 2 0 2 2 2 0 2 0 2 0 2
2 0 2 0 0 0 0 0 2 0 2 0 0 0 2 0 2
2 0 2 2 2 2 2 2 2 0 2 3 2 2 2 0 2
2 0 2 0 0 0 2 0 0 0 2 0 0 0 3 0 2
2 0 2 2 2 0 2 2 2 0 2 0 2 0 2 0 2
2 0 0 0 2 0 0 0 2 0 2 0 2 0 0 0 4
2 0 2 2 2 2 2 0 2 0 2 0 2 4 2 2 2
2 0 0 0 0 0 0 0 2 0 3 0 0 0 2 0 2
2 2 2 3 2 2 2 2 2 0 2 2 2 0 2 0 2
2 0 2 0 0 0 3 0 0 0 0 0 2 0 2 0 2
2 3 2 0 2 0 2 2 2 2 2 3 2 0 2 0 2
2 0 0 0 4 0 0 0 0 0 3 0 0 0 4 0 2
2 0 2 2 2 4 2 2 2 0 2 0 2 2 2 0 2
2 0 0 0 0 0 0 0 2 0 0 0 4 0 0 0 2
2 2 2 2 2 2 2 2 2 4 2 2 2 2 2 2 2
1 1 Dir.NORTH
1 3 Dir.EAST
3 3 Dir.NORTH
3 5 Dir.EAST
5 5 Dir.SOUTH
5 3 Dir.EAST
7 3 Dir.EAST
9 3 Dir.SOUTH
9 1 Dir.EAST
11 1 Dir.NORTH
11 3 Dir.EAST
13 3 Dir.NORTH
13 5 Dir.NORTH
13 7 Dir.WEST
11 7 Dir.NORTH
11 9 Dir.NORTH
11 11 Dir.EAST
13 11 Dir.SOUTH
13 9 Dir.EAST
15 9 Dir.NORTH
15 11 Dir.NORTH
15 13 Dir.NORTH
15 15 Dir.NORTH
