6
../Textures/Tiles074_2K_Color1024.png
../Textures/Plaster001_2K_Color1024.png
../Textures/PavingStones087_2K_Color1024.png
../Textures/arrow-right-long.png
../Textures/arrow-left-long.png
../Textures/goal.png
17 17
2 2 2 2 2 2 2 2 2 2 2 2 2 2 2 5 2
2 0 0 0 2 0 0 0 0 0 0 0 0 0 2 0 5
2 2 2 0 2 0 2 2 2 2 2 0 2 3 2 0 2
2 0 0 0 2 0 2 0 0 0 2 0 2 0 0 0 4
2 0 2 2 2 0 2 0 2 2 2 0 2 0 2 4 2
2 0 0 0 0 0 2 0 2 0 0 0 3 0 0 0 2
2 0 2 2 2 2 2 0 2 0 2 3 2 2 2 0 2
2 0 0 0 0 0 0 0 2 0 2 0 0 0 0 0 4
2 2 2 2 2 2 2 2 2 0 2 0 2 2 2 4 2
2 0 0 0 0 0 2 0 0 0 3 0 0 0 0 0 2
2 0 2 2 2 0 2 0 2 0 2 2 2 3 2 0 2
2 0 0 0 2 0 2 0 2 0 0 0 2 0 0 0 4
2 2 2 0 2 0 2 0 2 2 2 0 2 0 2 2 2
2 0 0 0 2 0 0 0 2 0 0 0 2 0 2 0 2
2 0 2 2 2 2 2 2 2 2 2 2 2 0 2 0 2
2 0 0 0 0 0 0 0 0 0 0 0 0 0 4 0 2
2 2 2 2 2 2 2 2 2 2 2 2 2 2 2 2 2
1 1 Dir.EAST
3 1 Dir.EAST
5 1 Dir.EAST
7 1 Dir.EAST
9 1 Dir.EAST
11 1 Dir.EAST
13 1 Dir.NORTH
13 3 Dir.NORTH
13 5 Dir.EAST
15 5 Dir.NORTH
15 7 Dir.WEST
13 7 Dir.WEST
11 7 Dir.NORTH
11 9 Dir.EAST
13 9 Dir.EAST
15 9 Dir.NORTH
15 11 Dir.WEST
13 11 Dir.NORTH
13 13 Dir.EAST
15 13 Dir.NORTH
15 15 Dir.NORTH
