6
../Textures/Tiles074_2K_Color1024.png
../Textures/Plaster001_2K_Color1024.png
../Textures/PavingStones087_2K_Color1024.png
../Textures/arrow-right-long.png
../Textures/arrow-left-long.png
../Textures/goal.png
17 17
2 2 2 3 2 2 2 2 2 2 2 2 2 2 2 5 2
2 0 0 0 0 0 0 0 0 0 0 0 3 0 0 0 5
2 0 2 0 2 4 2 2 2 2 2 0 2 2 2 0 2
2 0 3 0 0 0 2 0 0 0 0 0 0 0 0 0 4
2 0 2 3 2 0 2 0 2 2 2 4 2 2 2 0 2
2 0 2 0 0 0 4 0 0 0 2 0 0 0 2 0 2
2 0 2 0 2 2 2 2 2 2 2 2 2 0 2 2 2
2 0 2 0 2 0 0 0 2 0 0 0 2 0 0 0 2
2 3 2 0 2 0 2 0 2 0 2 0 2 2 2 0 2
2 0 0 0 4 0 2 0 0 0 2 0 2 0 0 0 2
2 0 2 4 2 0 2 2 2 2 2 0 2 0 2 2 2
3 0 0 0 2 0 0 0 0 0 2 0 2 0 2 0 2
2 3 2 0 2 0 2 2 2 2 2 0 2 0 2 0 2
2 0 0 0 4 0 2 0 0 0 0 0 2 0 0 0 2
2 0 2 2 2 0 2 0 2 2 2 2 2 2 2 0 2
2 0 0 0 0 0 2 0 0 0 0 0 0 0 0 0 2
2 2 2 2 2 2 2 2 2 2 2 2 2 2 2 2 2
1 1 Dir.NORTH
1 3 Dir.EAST
3 3 Dir.NORTH
3 5 Dir.WEST
1 5 Dir.NORTH
1 7 Dir.EAST
3 7 Dir.NORTH
3 9 Dir.NORTH
3 11 Dir.EAST
5 11 Dir.NORTH
5 13 Dir.WEST
3 13 Dir.NORTH
3 15 Dir.EAST
5 15 Dir.EAST
7 15 Dir.EAST
9 15 Dir.EAST
11 15 Dir.SOUTH
11 13 Dir.EAST
13 13 Dir.EAST
15 13 Dir.NORTH
15 15 Dir.NORTH
